+++++++++++++++++++
+++++++++++++++++++
*******************
*x ?     *  & x   *
* ** *** * *** ** *
* ** *** * *** ** *
*    @           ?*
* ** * ***** * ** *
*    *   *   *    *
**** *** * *** ****
**** *+++++++* ****
**** *+**+**+* ****
     ++*+0+*++     
**** *+**+**+* ****
****?*+++++++* ****
**** *** * *** ****
*    *   *   *    *
* ** * ***** * ** *
*        =       x*
* ** *** * *** ** *
* ** *** * *** ** *
*e x          ?   *
*******************